20,20
01,01,01,01,01,01,01,01,01,01,01,01,01,01,01,01,01,01,01,01
01,01,01,01,01,01,01,01,01,01,01,01,01,01,01,01,01,01,01,01
01,01,01,01,01,01,01,01,01,01,01,01,01,01,01,01,01,01,01,01
01,01,01,01,02,02,02,02,02,02,02,02,02,02,02,02,01,01,01,01
01,04,01,01,02,04,01,05,01,01,06,06,06,04,04,02,01,01,01,01
01,04,04,01,02,01,01,05,01,01,07,08,07,01,04,02,01,04,01,01
01,01,01,01,02,01,01,05,01,01,01,05,01,01,01,02,01,01,01,01
01,01,01,01,02,01,05,05,05,01,01,05,01,01,01,02,01,01,01,01
01,01,01,01,02,05,05,11,05,05,05,05,01,01,01,02,01,01,01,01
01,01,01,01,02,01,05,05,05,01,01,01,01,01,04,02,01,01,01,01
01,01,01,01,02,01,01,05,01,01,01,01,01,03,03,02,01,01,01,01
01,01,01,01,02,01,01,05,05,05,05,01,01,03,04,02,01,01,01,01
01,04,01,01,02,01,01,01,01,01,05,01,01,09,01,01,01,01,01,01
01,01,01,01,02,01,01,01,01,01,05,01,01,03,04,02,01,01,01,01
01,01,01,01,02,01,01,01,01,01,05,01,04,03,04,02,01,01,01,01
01,01,01,01,02,01,01,01,01,04,05,01,04,04,04,02,01,01,01,01
01,01,01,01,02,02,02,02,02,02,02,02,02,02,02,02,01,01,01,01
01,01,01,01,01,01,01,01,01,01,01,01,01,01,01,01,01,01,01,01
01,01,01,01,01,01,01,01,01,01,01,01,01,01,01,01,01,01,01,01
01,01,01,01,01,01,01,01,01,01,01,01,01,01,01,01,01,01,01,01

