20,20
04,04,04,04,04,04,04,04,04,04,04,04,04,04,04,04,04,04,04,04
04,04,04,04,04,04,04,04,04,04,04,04,04,04,04,04,04,04,04,04
04,04,04,04,04,04,04,04,04,04,04,04,04,04,04,04,04,04,04,04
04,04,04,04,04,04,04,04,04,04,04,04,04,04,04,04,04,04,04,04
04,04,04,04,04,01,01,01,04,04,04,04,04,04,04,04,04,04,04,04
04,04,04,04,04,01,04,01,01,01,01,04,04,04,04,04,04,04,04,04
04,04,04,04,04,01,04,04,04,04,01,01,01,01,04,04,04,04,04,04
04,04,04,04,04,01,04,04,04,04,04,01,04,04,04,04,04,04,04,04
04,04,04,04,04,01,04,04,04,04,04,01,04,04,04,04,04,04,04,04
04,04,04,04,04,01,04,04,04,04,04,01,01,01,04,04,04,04,04,04
04,04,04,04,04,01,04,04,04,04,04,04,04,01,04,04,04,04,04,04
04,04,04,04,04,01,01,01,01,01,01,04,01,01,04,04,04,04,04,04
01,01,01,01,01,01,04,04,04,04,01,04,01,04,04,04,04,04,04,04
04,04,04,04,04,01,01,01,04,04,01,01,01,04,04,04,04,04,04,04
04,04,04,04,04,04,04,01,01,01,01,04,04,04,04,04,04,04,04,04
04,04,04,04,04,04,04,04,04,04,01,04,04,04,04,04,04,04,04,04
04,04,04,04,04,04,04,04,04,04,04,04,04,04,04,04,04,04,04,04
04,04,04,04,04,04,04,04,04,04,04,04,04,04,04,04,04,04,04,04
04,04,04,04,04,04,04,04,04,04,04,04,04,04,04,04,04,04,04,04
04,04,04,04,04,04,04,04,04,04,04,04,04,04,04,04,04,04,04,04

