20,20
01,01,01,01,01,01,01,01,01,01,01,01,01,01,01,01,01,01,01,01
01,01,01,01,01,01,01,01,01,01,01,01,01,01,01,01,01,01,01,01
01,01,01,01,01,01,01,01,01,01,01,01,01,01,01,01,01,01,01,01
01,01,01,01,01,01,01,01,01,01,01,01,01,01,01,01,01,01,01,01
01,04,01,01,01,01,01,01,01,01,01,01,01,01,01,01,01,01,01,01
01,04,04,01,01,01,01,01,01,01,01,01,01,01,01,01,01,04,01,01
01,01,01,01,02,02,02,02,02,02,02,02,02,02,02,01,01,01,01,01
01,01,01,01,02,13,05,05,05,05,05,05,05,05,02,01,01,01,01,01
01,01,01,01,02,05,05,05,05,05,05,05,05,05,02,01,01,01,01,01
01,01,01,01,02,05,05,05,05,05,05,05,05,05,02,01,01,01,01,01
01,01,01,01,02,05,05,05,05,05,05,05,05,05,02,01,01,01,01,01
01,01,01,01,02,12,05,05,05,05,05,05,05,05,02,01,01,01,01,01
01,04,01,01,02,05,05,05,05,05,05,05,05,05,02,01,01,01,01,01
01,01,01,01,02,05,05,05,05,05,05,05,05,05,02,01,01,01,01,01
01,01,01,01,02,05,05,05,05,05,05,05,05,05,02,01,01,01,01,01
01,01,01,01,02,02,02,02,02,05,02,02,02,02,02,01,01,01,01,01
01,01,01,01,01,01,01,01,01,01,01,01,01,01,01,01,01,01,01,01
01,01,01,01,01,01,01,01,01,01,01,01,01,01,01,01,01,01,01,01
01,01,01,01,01,01,01,01,01,01,01,01,01,01,01,01,01,01,01,01
01,01,01,01,01,01,01,01,01,01,01,01,01,01,01,01,01,01,01,01

