20,20
01,01,01,01,01,01,01,01,01,01,01,01,01,01,01,01,01,01,01,01
01,01,01,01,01,01,01,01,01,01,01,01,01,01,01,01,01,01,01,01
01,01,01,01,01,01,01,01,01,01,01,01,01,01,01,01,01,01,01,01
01,01,01,01,01,01,01,01,01,01,01,01,01,01,01,01,01,01,01,01
01,04,01,01,01,01,01,01,01,01,01,01,01,01,01,01,01,01,01,01
01,04,04,01,01,01,01,01,01,01,01,01,01,01,01,01,01,04,01,01
01,01,01,01,02,02,02,02,02,02,02,02,02,02,02,01,01,01,01,01
01,01,01,01,02,05,05,05,05,05,05,05,05,13,02,01,01,01,01,01
01,01,01,01,02,05,05,05,05,05,05,05,05,05,02,01,01,01,01,01
01,01,01,01,02,05,14,05,05,05,05,05,05,05,02,01,01,01,01,01
01,01,01,01,02,05,15,05,05,05,05,05,05,05,02,01,01,01,01,01
01,01,01,01,02,05,05,05,05,05,05,05,05,05,02,01,01,01,01,01
01,04,01,01,02,05,05,05,05,05,05,05,05,05,02,01,01,01,01,01
01,01,01,01,02,05,05,05,05,05,05,05,05,05,02,01,01,01,01,01
01,01,01,01,02,05,05,05,05,05,05,05,05,05,02,01,01,01,01,01
01,01,01,01,02,02,02,02,02,02,02,02,02,02,02,01,01,01,01,01
01,01,01,01,01,01,01,01,01,01,01,01,01,01,01,01,01,01,01,01
01,01,01,01,01,01,01,01,01,01,01,01,01,01,01,01,01,01,01,01
01,01,01,01,01,01,01,01,01,01,01,01,01,01,01,01,01,01,01,01
01,01,01,01,01,01,01,01,01,01,01,01,01,01,01,01,01,01,01,01

